1111111111111
1C11000000001
1000P01E10101
1111111111111