111111111111111111111111111111111111
1000000M000000000C0000000M00C0000001
10100010C010001000010001110100010101
10100010C01101100P010001000110011101
101110111C1010100001110111010101C101
101010101010M01000010101000100110101
10111010101000101101110111010M010101
1000000000C000001E00000C0000M00CC001
100000000000001111111000000000000001
100000000000010000000100M00000000001
10000M0000000100000001000000000M0001
100000000000010011100100M00000000001
10000000000001010001010000000000M001
100000000000010100010100M00000000001
1000000000000100111001000000000M0001
100000000000010000000100000000000001
100000000000010000000100000000000001
100000000000001111111000000000000001
100000000000000000000000000000000001
111111111111111111111111111111111111