111111111111111111111111111111111111
10000000000000000C0000000000C0000001
10100010C010001000010001110100010101
10100010C01101100P010001000110011101
101110111C1010100001110111010101C101
101010101010001000010101000100110101
101110101010001011011101110100010101
1000000000C000001E00000C0000000CC001
111111111111111111111111111111111111